################################################################
#                                                              #
#      ########    #     #   ########   ########   #       #   #
#      #           ##    #   #          #          ##     ##   #
#      #           # #   #   #          #          # #   # #   #
       ########    #  #  #   ########   ########   #  # #  #    
#      #           #   # #          #   #          #   #   #   #
#      #           #    ##          #   #          #       #   #
#      ########    #     #   ########   ########   #       #   #
#                                                              #
################################################################